6 10
.--------.
|........|
|........|
|........|
|........|
'--------'