6 10
,--------,
|........|
|........|
|........|
|........|
'--------'
